1100 1100 1100 1100 1100 1100 1100 1100 1100 1208 2103 2000 2000 2000 2000 2000 2000 2000 2000 2000 2000 2000 2000 2000 2000 2000 2000 2000 2000 2000 2000 2000 2000 2000 2000 2000 2000 2000 2000 2000 2000 2000 2000 2000 2000 2000 2000 2000 2117 2102
1100 1100 1100 1100 1100 1100 1100 1100 1100 1208 2107 2102 2114 2000 2000 2000 2000 2000 2000 2000 2000 2000 2000 2000 2000 2000 2000 2000 2000 2000 2000 2000 2000 2000 2000 2000 2000 2000 2000 2000 2117 2102 2102 2102 2102 2102 2102 2102 2106 1200
1100 1100 1100 1100 1100 1100 1100 1100 1100 1211 1207 1204 2107 2114 2000 2000 2000 2000 2000 2000 2000 2000 2000 2000 2000 2000 2000 2000 2000 2000 2000 2000 2000 2000 2000 2000 2000 2000 2117 2102 2106 1200 1200 1200 1200 1200 1200 1200 1207 1207
1100 1100 1100 1212 1209 1100 1100 1100 1100 1100 1100 1208 1200 2107 2114 2000 2000 2000 2000 2000 2000 2000 2000 2000 2000 2000 2000 2000 2000 2000 2000 2000 2000 2117 2102 2102 2102 2102 2106 1200 1200 1200 1200 1200 1200 1200 1200 1210 1000 1000
1100 1100 1100 1208 1200 1214 1214 1214 1214 1214 1214 1207 1204 1200 2107 2102 2102 2102 2114 2000 2000 2000 2000 2000 2000 2000 2000 2000 2000 2000 2117 2102 2102 2106 1200 1200 1200 1200 1200 1200 1200 1200 1200 1200 1200 1207 1210 1000 1000 1000
1100 1100 1100 1211 1210 1100 1100 1100 1100 1100 1100 1000 1208 1200 1200 1200 1200 1200 2107 2102 2102 2102 2102 2102 2102 2102 2102 2102 2102 2102 2106 1200 1200 1200 1200 1200 1200 1200 1200 1200 1200 1200 1207 1207 1210 1000 1000 1000 1100 1100
1100 1100 1100 1100 1100 1100 1100 1100 1100 1100 1100 1000 1208 1200 1200 1200 1200 1200 1200 1200 1200 1200 1200 1200 1200 1200 1200 1200 1200 1200 1200 1200 1200 1200 1200 1200 1200 1200 1200 1200 1207 1210 1000 1000 1000 1000 1000 1100 1100 1100
1100 1100 1100 1100 1100 1100 1100 1100 1100 1100 1100 1000 1208 1200 1200 1200 1200 1200 1200 1200 1200 1200 1200 1200 1200 1200 1200 1200 1200 1200 1200 1200 1200 1200 1200 1207 1207 1207 1207 1210 1000 1000 1000 1100 1100 1100 1100 1100 1100 1100
1100 1100 1100 1100 1100 1100 1100 1100 1100 1100 1100 1000 1208 1200 1200 1200 1200 1200 1200 1200 1200 1200 1200 1200 1200 1200 1200 1200 1200 1200 1200 1200 1200 1207 1210 1000 1000 1000 1000 1000 1000 1100 1100 1100 1100 1100 1100 1100 3000 3000
1100 1100 1100 1100 1100 1100 1100 1100 1100 1100 1100 1000 1211 1207 1207 1207 1207 1207 1207 1207 1207 1207 1207 1204 1200 1203 1207 1207 1207 1207 1207 1207 1210 1000 1000 1000 1100 1100 1100 1100 1100 1100 1100 1100 1100 1100 1100 1100 3000 3000
1100 1100 1100 1100 1100 1100 1100 1100 1100 1100 1100 1000 1000 1000 1000 1000 1000 1000 1000 1000 1000 1000 1000 1208 1200 1206 1000 1000 1000 1000 1000 1000 1000 1000 1100 1100 1100 1100 1100 1100 1100 1100 1100 1100 1100 1100 1100 1100 3000 3000
1100 1100 1100 1100 1100 1100 1100 1100 1100 1100 1100 1000 1000 1000 1000 1000 1000 1000 1000 1100 1100 1100 1100 1208 1200 1206 1100 1100 1100 1100 1100 1100 1100 1100 1100 1100 1100 1100 1100 1100 1100 1100 1100 1100 1100 1100 1100 1100 3000 3000
1100 1100 1100 1100 1100 1100 1100 1100 1100 1100 1100 1100 1100 1100 1100 1100 1100 1100 1100 1100 1100 1100 1100 1208 1200 1206 1100 1100 1100 1100 1100 1100 1100 1100 1100 1100 1100 1100 1100 1100 1100 1100 1100 1100 1100 1100 1100 1100 3000 3000
1100 1100 1100 1100 1100 1100 1100 1100 1100 1100 1100 1100 1100 1100 1100 1100 1100 1100 1100 1100 1100 1100 1100 1208 1200 1206 1100 1100 1100 1100 1100 1100 1100 1100 1100 1100 1100 1100 1100 1100 1100 1100 1100 1100 1100 1100 1100 1100 3000 3000
1100 1100 1100 1100 1100 1100 1100 1100 1100 1100 1100 1100 1100 1100 1212 1205 1205 1205 1205 1205 1205 1205 1205 1201 1200 1202 1205 1205 1205 1205 1205 1205 1205 1205 1205 1205 1205 1205 1205 1205 1205 1205 1205 1205 1205 1205 1205 1205 1205 1205
1100 1100 1100 1100 1100 1100 1100 1100 1100 1100 1100 1100 1100 1100 1208 1203 1207 1207 1207 1207 1207 1207 1207 1204 1200 1203 1207 1207 1207 1207 1207 1207 1207 1207 1207 1207 1207 1207 1207 1207 1207 1207 1207 1207 1207 1207 1207 1207 1207 1207
1100 1100 1100 1100 1100 1100 1100 1100 1100 1100 1100 1100 1100 1100 1208 1206 1100 1100 1100 1100 1100 1100 1100 1208 1200 1206 1100 1100 1100 1100 1100 1100 1100 1100 1100 1100 1100 1100 1100 1100 1100 1100 1100 1100 1100 1100 1100 1100 3000 3000
1100 1100 1100 1100 1100 1100 1100 1100 1100 1100 1100 1100 1100 1100 1208 1206 1100 1100 1100 1100 1100 1100 1100 1208 1200 1206 1100 1100 1100 1100 1100 1100 1100 1100 1100 1100 1100 1100 1100 1100 1100 1100 1100 1100 1100 1100 1100 1100 3000 3000
1100 1100 1100 1100 1100 1100 1100 1100 1100 1100 1100 1100 1100 1100 1208 1206 1100 1100 1100 1100 1100 1100 1100 1208 1200 1206 1100 1100 1100 1100 1100 1100 1100 1100 1100 1100 1100 1100 1100 1100 1100 1100 1100 1100 1100 1100 1100 1100 3000 3000
1100 1100 1100 1100 1100 1100 1100 1100 1100 1100 1100 1100 1100 1100 1208 1206 1100 1100 1100 1100 1100 1100 1100 1211 1207 1210 1100 1100 1100 1100 1100 1100 1100 1100 1100 1100 1100 1100 1100 1100 1100 1100 1100 1100 1100 1100 1100 1100 3000 3000
1100 1100 1100 1100 1100 1100 1100 1100 1100 1100 1100 1100 1100 1100 1208 1206 1100 1100 1100 1100 1100 1100 1100 1100 1100 1100 1100 1100 1100 1100 1100 1100 1100 1100 1100 1100 1100 1100 1100 1100 1100 1100 1100 1100 1100 1100 1100 1100 3000 3000
1100 1100 1100 1100 1100 1100 1100 1100 1100 1100 1100 1100 1100 1100 1208 1206 1100 1100 1100 1100 1100 1100 1100 1100 1100 1100 1100 1100 1100 1100 1100 1100 1100 1100 1100 1100 1100 1100 1100 1100 1100 1100 1100 1100 1100 1100 1100 1100 3000 3000
1100 1100 1100 1100 1100 1100 1100 1100 1100 1100 1100 1100 1100 1100 1208 1206 1100 1100 1100 1100 1100 1100 1100 1100 1100 1100 1100 1100 1100 1100 1100 1100 1100 1100 1100 1100 1100 1100 1100 1100 1100 1100 1100 1100 1100 1100 1100 1100 3000 3000
1100 1100 1100 1100 1100 1100 1100 1100 1100 1100 1100 1100 1100 1100 1208 1206 1100 1100 1100 1100 1100 1100 1100 1100 1100 1100 1100 1100 1100 1100 1100 1100 1100 1100 1100 1100 1100 1100 1100 1100 1100 1100 1100 1100 1100 1100 1100 1100 3000 3000
1100 1100 1100 1100 1100 1100 1100 1100 1100 1100 1100 1100 1100 1100 1208 1206 1100 1100 1100 1100 1100 1100 1100 1100 1100 1100 1100 1100 1100 1100 1100 1100 1100 1100 1100 1100 1100 1100 1100 1100 1100 1100 1100 1100 1100 1100 1100 1100 3000 3000
1100 1100 1100 1100 1100 1100 1100 1100 1100 1100 1100 1100 1100 1100 1208 1206 1100 1100 1100 1100 1100 1100 1100 1100 1100 1100 1100 1100 1100 1100 1100 1100 1100 1100 1100 1100 1100 1100 1100 1100 1100 1100 1100 1100 1100 1100 1100 1100 3000 3000
1100 1100 1100 1100 1100 1100 1100 1100 1100 1100 1100 1100 1100 1100 1208 1206 1100 1100 1100 1100 1100 1100 1100 1100 1100 1100 1100 1100 1100 1100 1100 1100 1100 1100 1100 1100 1100 1100 1100 1100 1100 1100 1100 1100 1100 1100 1100 1100 1100 1100
1100 1100 1100 1100 1100 1100 1100 1100 1100 1100 1100 1100 1100 1100 1208 1206 1100 1100 1100 1100 1100 1100 1100 1100 1100 1100 1100 1100 1100 1100 1100 1100 1100 1100 1100 1100 1100 1100 1100 1100 1100 1100 1100 1100 1100 1100 1100 1100 1100 1100
1100 1100 1100 1100 1100 1100 1100 1100 1100 1100 1100 1100 1100 1100 1208 1206 1100 1100 1100 1100 1100 1100 1100 1100 1100 1100 1100 1100 1100 1100 1100 1100 1100 1100 1100 1100 1100 1100 1100 1100 1100 1100 1100 1100 1100 1100 1100 1100 1100 1100
1100 1100 1100 1100 1100 1100 1100 1100 1100 1100 1100 1100 1100 1100 1208 1206 1100 1100 1100 1100 1100 1100 1100 1100 1100 1100 1100 1100 1100 1100 1100 1100 1100 1100 1100 1100 1100 1100 1100 1100 1100 1100 1100 1100 1100 1100 1100 1100 1100 1100
1100 1100 1100 1100 1100 1100 1100 1100 1100 1100 1000 1000 1000 1000 1208 1206 1000 1000 1000 1000 1100 1100 1100 1100 1100 1100 1100 1100 1100 1100 1100 1100 1100 1100 1100 1100 1100 1100 1100 1100 1100 1100 1100 1100 1100 1100 1100 1100 1100 1100
1100 1100 1100 1100 1100 1100 1100 1100 1000 1000 1000 1000 1212 1205 1200 1200 1205 1209 1000 1000 1000 1000 1100 1100 1100 1100 1100 1100 1100 1100 1100 1100 1100 1100 1100 1100 1100 1100 1100 1100 1100 1100 1100 1100 1100 1100 1100 1100 1100 1100
1100 1100 1100 1100 1100 1100 1100 1212 1205 1205 1205 1205 1201 1200 1200 1200 1200 1202 1205 1205 1205 1209 1100 1100 1100 1100 1100 1100 1100 1100 1100 1100 1100 1100 1100 1100 1100 1100 1100 1100 1100 1100 1100 1100 1100 1100 1100 1100 1100 1100
1100 1100 1100 1100 1100 1100 1100 1208 2104 2100 2100 2105 1200 1200 1200 1200 1200 1200 2104 2100 2105 1206 1100 1100 1100 1100 1100 1100 1100 1100 1100 1100 1100 1100 1100 1100 1100 1100 1100 1100 1100 1100 1100 1100 1100 1100 1100 1100 1100 1100
1100 1100 1100 1100 1100 1100 1100 1208 2103 2000 2000 2101 1200 1200 1200 1200 1200 1200 2103 2000 2101 1206 1100 1100 1100 1100 1100 1100 1100 1100 1100 1100 1100 1100 1100 1100 1100 1100 1100 1100 1100 1100 1100 1100 1100 1100 1100 1100 1100 1100
1100 1100 1100 1100 1100 1100 1100 1208 2103 2000 2000 2000 2100 2100 2100 2100 2100 2100 2000 2000 2101 1206 1100 1100 1100 1100 1100 1100 1100 1100 1100 1100 1100 1100 1100 1100 1100 1100 1100 1100 1100 1100 1100 1100 1100 1100 1100 1100 1100 1100
1100 1100 1100 1100 1100 1100 1100 1208 2107 2102 2102 2102 2102 2102 2102 2102 2102 2102 2102 2102 2106 1206 1100 1100 1100 1100 1100 1100 1100 1100 1100 1100 1100 1100 1100 1100 1100 1100 1100 1100 1100 1100 1100 1100 1100 1100 1100 1100 1100 1100
1100 1100 1100 1100 1100 1100 1100 1211 1207 1207 1207 1207 1207 1207 1207 1207 1207 1207 1207 1207 1207 1210 1100 1100 1100 1100 1100 1100 1100 1100 1100 1100 1100 1100 1100 1100 1100 1100 1100 1100 1100 1100 1100 1100 1100 1100 1100 1100 1100 1100
1100 1100 1100 1100 1100 1100 1100 1100 1100 1100 1100 1100 1100 1100 1100 1100 1100 1100 1100 1100 1100 1100 1100 1100 1100 1100 1100 1100 1100 1100 1100 1100 1100 1100 1100 1100 1100 1100 1100 1100 1100 1100 1100 1100 1100 1100 1100 1100 1100 1100
1100 1100 1100 1100 1100 1100 1100 1100 1100 1100 1100 1100 1100 1100 1100 1100 1100 1100 1100 1100 1100 1100 1100 1100 1100 1100 1100 1100 1100 1100 1100 1100 1100 1100 1100 1100 1100 1100 1100 1100 1100 1100 1100 1100 1100 1100 1100 1100 1100 1100
1100 1100 1100 1100 1100 1100 1100 1100 1100 1100 1100 1100 1100 1100 1100 1100 1100 1100 1100 1100 1100 1100 1100 1100 1100 1100 1100 1100 1100 1100 1100 1100 1100 1100 1100 1100 1100 1100 1100 1100 1100 1100 1100 1100 1100 1100 1100 1100 1100 1100
